Qxua^Xo, Qxua^Xo, Qxua^Xo, Qxua^Xo, Qxua^Xo, Qxua^Xo, Qxua^Xo, Qxua^Xo, Qxua^Xo, Qxua^Xo, Qxua^Xo, Qxua^Xo, Qxua^Xo, Qxua^Xo, Qxua^Xo, Qxua^Xo, Qxua^Xo, Qxua^Xo, Qxua, Qxua^Xo, Qxua^Xo, Qxua^Xo, Qxua^Xo, Qxua^Xo, Qxua^Xo, Qxua^Xo, Qxua^Xo, Qxua^Xo, Qxua^Xo, Qxua^Xo, Qxua^Xo, Qxua^Xo, Qxua^Xo, Qxua^Xo, Qxua^Xo
Qxua^Xo, Qxua^Xo, Qxua^Xo, Qxua^Xo, Qxua^Xo, Qxua^Xo, Qxua^Xo, Qxua^Xo, Qxua, Qxua, Qxua, Qxua^Xo, Qxua^Xo, Qxua^Xo, Qxua^Xo, Qxua^Xo, Qxua, Qxua, Re, Qxua, Qxua, Qxua^Xo, Qxua^Xo, Qxua^Xo, Qxua, Qxua^Xo, Qxua, Qxua, Qxua, Qxua^Xo, Qxua^Xo, Qxua^Xo, Qxua^Xo, Qxua^Xo, Qxua^Xo
Qxua^Xo, Qxua^Xo, Qxua^Xo, Qxua^Xo, Qxua^Xo, Qxua^Xo, Qxua, Qxua, Re, Re, Re, Qxua, Qxua, Qxua^Xo, Qxua, Qxua^Xo, Qxua, Rd, Re, Re, Re, Qxua, Qxua^Xo, Qxua, Rd, Qxua, Re, Re, Re, Qxua, Qxua, Qxua^Xo, Qxua^Xo, Qxua^Xo, Qxua^Xo
Qxua^Xo, Qxua^Xo, Qxua^Xo, Qxua^Xo, Qxua^Xo, Qxua^Xo, Qxua, Rd, Re, Re^Rusy, Re, Qxua, Rd, Qxua, Rd, Qxua, Rd, Rd, Re^Es, Re^Es, Re^Es, Qxua, Qxua, Qxua, Rd, Rd, Re^Rusy, Re^Es, Re, Rd, Qxua, Qxua^Xo, Qxua^Xo, Qxua^Xo, Qxua^Xo
Qxua^Xo, Qxua^Xo, Qxua^Xo, Qxua^Xo, Qxua^Xo, Qxua^Xo, Qxua^Xo, Qxua, Rd, Re^Rusy, Rd^Es, Rd, Qxua, Rd, Qxua, Rd, Re, Re^Rusy, Re, Re^Es, Re^Rusy, Rd, Rd, Rd, Rd^Rusy, Re, Rd, Re, Qxua, Qxua, Qxua, Qxua^Xo, Qxua^Xo, Qxua^Xo, Qxua^Xo
Qxua^Xo, Qxua^Xo, Qxua^Xo, Qxua^Xo, Qxua^Xo, Qxua^Xo, Qxua^Xo, Qxua, Qxua, Qxua, Qxua, Rd^Es, Qxua, Qxua, Qxua, Qxua, Rd, Re, Re^Rusy, Re, Re^Rusy, Rd, Re^Rusy, Re, Re^Rusy, Re^Es, Re^Es, Re^Es, Re, Qxua, Rd, Qxua, Qxua^Xo, Qxua^Xo, Qxua^Xo
Qxua^Xo, Qxua^Xo, Qxua^Xo, Qxua^Xo, Qxua^Xo, Qxua^Xo, Qxua^Xo, Qxua^Xo, Qxua^Xo, Qxua^Xo, Qxua, Rd, Rd, Rd, Qxua, Qxua, Qxua, Rd^Es, Rd, Re^Rusy, Re, Re^Rusy, Re, Re^Rusy, Re, Re, Re, Re^Es, Re^Es, Rd, Qxua, Qxua, Qxua^Xo, Qxua^Xo, Qxua^Xo
Qxua^Xo, Qxua^Xo, Qxua^Xo, Qxua^Xo, Qxua^Xo, Qxua^Xo, Qxua^Xo, Qxua^Xo, Qxua^Xo, Qxua^Xo, Qxua^Xo, Qxua, Rd, Qxua, Rd^Es, Qxua, Qxua, Rd, Re^Rusy, Re^Rusy, Re, Rd, Rd^Es, Rd^Rusy, Rd, Qxua, Qxua, Re^Es, Rd^Es, Rd, Qxua, Qxua^Xo, Qxua^Xo, Qxua^Xo, Qxua^Xo
Qxua^Xo, Qxua^Xo, Qxua^Xo, Qxua^Xo, Qxua^Xo, Qxua^Xo, Qxua^Xo, Qxua^Xo, Qxua^Xo, Qxua^Xo, Qxua^Xo, Qxua, Qxua, Rd, Qxua, Rd^Es, Re, Re^Rusy, Re^Rusy, Re, Qxua, Qxua, Rd, Rd, Rd, Qxua, Qxua, Qxua, Qxua, Qxua, Qxua^Xo, Qxua^Xo, Qxua^Xo, Qxua^Xo, Qxua^Xo
Qxua^Xo, Qxua^Xo, Qxua^Xo, Qxua^Xo, Qxua^Xo, Qxua^Xo, Qxua^Xo, Qxua^Xo, Dd^Ruty, Qxua^Xo, Rd^Xo, Qxua^Xo, Qxua^Xo, Qxua, Qxua, Qxua, Rd, Re^Rusy, Re, Rd, Rd, Qxua, Rd^Es, Rd^Es, Re^Rusy, Rd, Rd, Qxua, Qxua^Xo, Qxua^Xo, Qxua^Xo, Qxua^Xo, Qxua^Xo, Qxua^Xo, Qxua^Xo
Qxua^Xo, Qxua^Xo, Qxua^Xo, Qxua^Xo, Qxua^Xo, Qxua^Xo, Qxua^Xo, Rd^Xo, Rd^Xo, Rd^Xo, Rd^Xo, Qxua^Xo, Qxua^Xo, Qxua^Xo, Qxua, Rd, Qxua, Qxua, Re, Re^Rusy, Rd, Rd, Re^Rusy, Re, Re^Rusy, Re^Rusy, Rd, Qxua, Qxua^Xo, Qxua^Xo, Qxua^Xo, Qxua^Xo, Qxua^Xo, Qxua^Xo, Qxua^Xo
Qxua^Xo, Qxua^Xo, Qxua^Xo, Qxua^Xo, Qxua^Xo, Qxua^Xo, Qxua^Xo, Qxua^Xo, Rd^Xo, Rd^Xo, Qxua^Xo, Qxua^Xo, Qxua^Xo, Qxua^Xo, Qxua, Gd, Gd, Qxua, Re, Re, Rd, Rd, Re, Re^Rusy, Re, Rd, Qxua, Qxua, Qxua^Xo, Qxua^Xo, Qxua^Xo, Qxua^Xo, Qxua^Xo, Qxua^Xo, Qxua^Xo
Qxua^Xo, Qxua^Xo, Qxua^Xo, Qxua^Xo, Qxua^Xo, Qxua^Xo, Qxua^Xo, Qxua^Xo, Qxua^Xo, Qxua^Xo, Qxua, Qxua, Qxua, Qxua^Xo, Qxua, Qxua, Rd, Gd, Re, Re, Rd^Es, Re, Re, Re, Qxua, Gd, Qxua, Qxua^Xo, Qxua^Xo, Qxua^Xo, Rd, Qxua^Xo, Qxua^Xo, Qxua^Xo, Qxua^Xo
Qxua^Xo, Qxua^Xo, Qxua^Xo, Qxua^Xo, Qxua^Xo, Qxua^Xo, Qxua, Qxua, Qxua, Qxua, Gd^Efm, Gd, Gd, Qxua, Rd, Qxua, Rd, Qxua, Qxua, Rd^Es, Rd^Es, Re, Re, Gd^Es, Gd, Gd, Rd, Qxua, Rd^Xo, Dd^Ruty, Rd, Rd, Qxua^Xo, Qxua^Xo, Qxua^Xo
Qxua^Xo, Qxua^Xo, Qxua^Xo, Qxua^Xo, Qxua, Qxua, Gd, Gd, Gd^Efm, Gd, Qxua, Qxua, Gd, Rd, Gd, Rd, Rd, Qxua, Qxua, Rd, Rd^Es, Rd, Re^Es, Re, Qxua, Qxua, Gd^Efm, Qxua, Qxua, Rd^Xo, Rd^Xo, Rd, Qxua^Xo, Qxua^Xo, Qxua^Xo
Qxua^Xo, Qxua^Xo, Qxua^Xo, Qxua^Xo, Qxua, Rd, Gd, Qxua, Gd^Efm, Qxua, Qxua, Rd, Gd^Efm, Gd^Efm, Qxua, Qxua, Qxua, Rd, Re, Rd, Re^Rusy, Rd, Rd, Rd, Qxua, Gd, Gd^Efm, Rd, Qxua, Qxua, Qxua, Qxua^Xo, Qxua^Xo, Qxua^Xo, Qxua^Xo
Qxua^Xo, Qxua^Xo, Qxua^Xo, Qxua^Xo, Qxua^Xo, Qxua, Qxua, Rd, Gd, Qxua, Gd, Gd^Efm, Gd, Qxua, Qxua, Qxua, Gd, Re, Re^Rusy, Re, Gd, Rd, Rd, Qxua, Gd, Gd^Efm, Qxua, Rd, Rd, Rd, Qxua, Qxua^Xo, Qxua^Xo, Qxua^Xo, Qxua^Xo
Qxua^Xo, Qxua^Xo, Rd, Rd, Rd, Qxua^Xo, Qxua^Xo, Qxua, Qxua, Gd, Qxua, Gd, Qxua, Qxua, Qxua, Gd, Re, Re^Rusy, Re^Rusy, Re^Rusy, Re, Gd, Re, Re, Re^Rusy, Gd, Qxua, Qxua, Rd, Rd, Qxua, Qxua^Xo, Qxua^Xo, Qxua^Xo, Qxua^Xo
Qxua^Xo, Qxua^Xo, Rd, Rd^Es, Rd^Es, Rd^Es, Qxua^Xo, Qxua^Xo, Qxua^Xo, Qxua, Rd^Es, Rd^Es, Qxua, Qxua, Qxua, Rd, Rd, Re^Rusy, Re^Rusy, Re^Rusy, Re^Rusy, Gd, Rd, Re, Rd, Rd, Qxua, Qxua, Qxua, Rd^Es, Rd, Qxua, Qxua^Xo, Qxua^Xo, Qxua^Xo
Qxua^Xo, Qxua^Xo, Qxua^Xo, Rd, Qxua^Xo, Rd, Qxua^Xo, Qxua^Xo, Qxua, Qxua, Rd, Qxua, Qxua, Qxua, Rd, Qxua, Rd, Re, Re^Rusy, Re^Rusy, Rd, Rd^Rusy, Gd, Gd, Rd, Qxua, Qxua, Qxua, Qxua, Rd^Es, Rd, Qxua, Qxua^Xo, Qxua^Xo, Qxua^Xo
Qxua^Xo, Qxua^Xo, Qxua^Xo, Qxua^Xo, Qxua^Xo, Qxua^Xo, Qxua, Qxua, Qxua, Rd, Qxua, Rd, Rd, Rd, Re^Rusy, Rd, Re^Rusy, Re^Rusy, Re^Rusy, Re^Rusy, Re^Rusy, Gd, Gd, Rd^Rusy, Rd, Qxua, Rd^Es, Rd, Rd, Rd, Qxua, Qxua, Qxua^Xo, Qxua^Xo, Qxua^Xo
Qxua^Xo, Qxua^Xo, Rd, Rd, Qxua^Xo, Qxua^Xo, Qxua, Rd, Gd, Rd, Qxua, Qxua, Re, Re^Rusy, Re^Rusy, Re^Rusy, Rd^Rusy, Re^Rusy, Re^Rusy, Re^Rusy, Rd, Gd^Efm, Rd, Gd^Efm, Gd^Efm, Qxua, Rd^Es, Rd, Qxua, Qxua, Qxua^Xo, Qxua^Xo, Qxua^Xo, Qxua^Xo, Qxua^Xo
Qxua^Xo, Qxua^Xo, Qxua^Xo, Qxua^Xo, Qxua^Xo, Qxua, Gd, Gd, Qxua, Qxua, Gd, Re, Re^Rusy, Re^Rusy, Re^Rusy, Re^Rusy, Re^Rusy, Re^Rusy, Re^Rusy, Rd, Rd, Rd, Qxua, Gd^Efm, Rd, Gd, Rd^Es, Rd, Rd, Qxua, Qxua^Xo, Qxua^Xo, Qxua^Xo, Qxua^Xo, Qxua^Xo
Qxua^Xo, Qxua^Xo, Qxua^Xo, Qxua^Xo, Qxua^Xo, Qxua, Gd, Qxua, Qxua, Qxua, Gd, Re, Re, Re^Rusy, Re^Rusy, Re^Rusy, Re^Rusy, Re, Re^Rusy, Rd^Rusy, Rd, Rd, Qxua, Rd, Re, Re^Rusy, Re, Rd^Es, Qxua, Qxua, Qxua^Xo, Qxua^Xo, Qxua^Xo, Qxua^Xo, Qxua^Xo
Qxua^Xo, Qxua^Xo, Qxua^Xo, Qxua^Xo, Qxua^Xo, Qxua, Gd, Qxua, Qxua, Qxua, Qxua, Gd, Re, Re, Rd, Rd^Rusy, Gd, Re, Re, Rd^Rusy, Rd, Qxua, Qxua, Qxua, Rd, Re^Rusy, Re, Qxua, Rd, Qxua, Qxua, Qxua^Xo, Qxua^Xo, Qxua^Xo, Qxua^Xo
Qxua^Xo, Qxua^Xo, Qxua^Xo, Qxua^Xo, Qxua^Xo, Qxua, Qxua, Rd, Rd, Gd, Rd, Gd, Gd^Efm, Gd, Rd, Rd, Gd, Qxua, Gd, Re, Rd, Rd, Re^Es, Gd, Gd, Re^Rusy, Re^Rusy, Rd, Rd^Es, Rd^Es, Qxua, Qxua^Xo, Qxua^Xo, Qxua^Xo, Qxua^Xo
Qxua^Xo, Qxua^Xo, Qxua^Xo, Qxua^Xo, Qxua^Xo, Qxua^Xo, Qxua^Xo, Qxua, Gd, Rd, Gd^Efm, Gd^Efm, Rd^Efm, Gd^Efm, Rd, Gd, Qxua, Qxua, Qxua, Rd, Re, Re^Rusy, Re, Gd, Gd, Re, Re, Re, Rd^Es, Rd, Rd^Es, Qxua, Rd, Qxua^Xo, Qxua^Xo
Qxua^Xo, Qxua^Xo, Qxua^Xo, Qxua^Xo, Qxua^Xo, Qxua^Xo, Qxua^Xo, Qxua, Gd, Gd, Gd^Efm, Gd^Efm, Qxua, Qxua, Qxua, Qxua, Qxua, Rd^Es, Rd, Rd, Rd, Re^Rusy, Re^Rusy, Rd^Es, Qxua, Qxua, Qxua, Qxua, Rd, Rd^Es, Rd, Qxua, Qxua^Xo, Rd, Qxua^Xo
Qxua^Xo, Qxua^Xo, Qxua^Xo, Qxua^Xo, Qxua^Xo, Qxua^Xo, Qxua^Xo, Qxua, Gd, Gd^Rusy, Gd^Efm, Gd, Qxua, Qxua, Qxua, Qxua, Rd, Rd^Es, Rd^Es, Rd, Qxua, Re, Re, Rd, Rd, Qxua, Qxua, Qxua, Rd^Es, Rd^Es, Rd, Qxua, Qxua, Qxua^Xo, Qxua^Xo
Qxua^Xo, Qxua^Xo, Qxua^Xo, Qxua^Xo, Dd^Ruty, Qxua^Xo, Rd^Xo, Qxua, Qxua, Gd^Efm, Gd, Gd, Gd, Qxua, Qxua, Qxua, Rd, Rd^Es, Rd, Rd, Qxua, Rd, Rd, Gd, Rd, Qxua, Qxua, Qxua, Gd^Efm, Rd, Gd^Efm, Gd, Qxua, Qxua^Xo, Qxua^Xo
Qxua^Xo, Qxua^Xo, Qxua^Xo, Rd^Xo, Rd^Xo, Rd^Xo, Rd^Xo, Qxua^Xo, Qxua, Rd, Gd, Gd^Efm, Gd, Gd, Rd, Qxua, Rd, Rd^Es, Qxua, Qxua, Qxua, Qxua, Rd, Gd, Rd, Qxua, Gd, Gd, Gd^Efm, Rd, Gd^Efm, Qxua, Qxua^Xo, Qxua^Xo, Qxua^Xo
Qxua^Xo, Qxua^Xo, Qxua^Xo, Qxua^Xo, Qxua^Xo, Rd^Xo, Qxua^Xo, Qxua^Xo, Qxua, Rd, Gd^Rusy, Gd^Efm, Gd, Gd, Gd, Rd, Rd^Es, Rd, Qxua, Qxua, Qxua, Qxua, Rd, Rd, Re, Gd, Re^Rusy, Re^Rusy, Gd, Gd^Efm, Qxua, Qxua, Qxua^Xo, Qxua^Xo, Qxua^Xo
Qxua^Xo, Qxua^Xo, Qxua^Xo, Qxua^Xo, Qxua^Xo, Qxua^Xo, Qxua, Qxua, Qxua, Qxua, Gd, Gd, Rd, Rd, Rd, Rd, Rd, Rd, Rd, Rd, Rd, Rd, Gd, Re, Rd, Re, Re, Re^Rusy, Gd, Gd, Qxua, Qxua^Xo, Qxua^Xo, Qxua^Xo, Qxua^Xo
Qxua^Xo, Qxua^Xo, Qxua^Xo, Qxua^Xo, Qxua^Xo, Qxua^Xo, Qxua, Rd, Rd, Rd, Rd, Rd, Qxua, Rd, Qxua, Gd, Gd^Efm, Gd^Efm, Gd^Efm, 5 Rd, Gd^Efm, Gd^Efm, Gd, Re, Rd, Qxua, Rd, Re, Gd, Qxua, Qxua^Xo, Qxua^Xo, Qxua^Xo, Qxua^Xo, Qxua^Xo
Qxua^Xo, Qxua^Xo, Qxua^Xo, Qxua^Xo, Qxua^Xo, Qxua^Xo, Qxua^Xo, Qxua, Rd^Es, Rd^Es, Qxua, Rd, Qxua, Qxua, Qxua, Rd, Gd, 6 Gd^Efm, Gd^Efm, Gd^Efm, Gd^Efm, 4 Rd, Gd, Rd, Qxua, Qxua, Qxua, Rd, Rd, Qxua, Qxua, Qxua^Xo, Qxua^Xo, Qxua^Xo, Qxua^Xo
Qxua^Xo, Qxua^Xo, Qxua^Xo, Qxua^Xo, Qxua^Xo, Qxua^Xo, Qxua, Qxua, Rd^Es, Qxua, Qxua, Rd^Es, Rd, Qxua, Qxua, Qxua, Gd, Gd, Gd, Gd^Efm, Gd^Efm, Gd^Efm, Gd^Efm, Gd, Gd^Efm, Qxua, Qxua^Xo, Qxua, Qxua, Rd, Rd, Qxua, Qxua^Xo, Qxua^Xo, Qxua^Xo
Qxua^Xo, Qxua^Xo, Qxua^Xo, Qxua^Xo, Qxua^Xo, Qxua, Rd, Qxua, Rd, Qxua, Qxua^Xo, Qxua, Qxua, Qxua, Qxua, Gd^Efm, Gd, 1 Rd^Efm, Gd, Gd^Efm, Rd, 3 Gd, Gd, Gd, Qxua, Qxua, Qxua^Xo, Qxua^Xo, Qxua, Rd, Qxua, Qxua, Qxua^Xo, Qxua^Xo, Qxua^Xo
Qxua^Xo, Qxua^Xo, Qxua^Xo, Qxua^Xo, Qxua^Xo, Qxua, Qxua, Rd, Qxua, Qxua, Qxua^Xo, Qxua^Xo, Qxua^Xo, Qxua, Gd, Gd, Qxua, Rd, Rd, 2 Gd, Gd, Gd, Qxua, Gd, Qxua, Qxua^Xo, Qxua^Xo, Qxua^Xo, Qxua^Xo, Qxua, Qxua^Xo, Qxua^Xo, Qxua^Xo, Qxua^Xo, Qxua^Xo
Qxua^Xo, Qxua^Xo, Qxua^Xo, Qxua^Xo, Qxua^Xo, Qxua^Xo, Qxua^Xo, Qxua, Qxua^Xo, Qxua^Xo, Qxua^Xo, Qxua^Xo, Qxua^Xo, Qxua, Qxua, Qxua, Qxua, Gd, Gd^Efm, Gd^Efm, Gd, Qxua, Qxua, Gd, Qxua, Qxua^Xo, Qxua^Xo, Qxua^Xo, Qxua^Xo, Qxua^Xo, Qxua^Xo, Qxua^Xo, Qxua^Xo, Qxua^Xo, Qxua^Xo
Qxua^Xo, Qxua^Xo, Qxua^Xo, Qxua^Xo, Qxua^Xo, Qxua^Xo, Qxua^Xo, Qxua^Xo, Qxua^Xo, Qxua^Xo, Qxua^Xo, Qxua^Xo, Qxua^Xo, Qxua^Xo, Qxua^Xo, Qxua^Xo, Qxua^Xo, Qxua, Qxua, Gd^Efm, Gd, Qxua, Qxua^Xo, Qxua, Qxua^Xo, Qxua^Xo, Qxua^Xo, Qxua^Xo, Qxua^Xo, Qxua^Xo, Qxua^Xo, Qxua^Xo, Qxua^Xo, Qxua^Xo, Qxua^Xo
Qxua^Xo, Qxua^Xo, Qxua^Xo, Qxua^Xo, Qxua^Xo, Qxua^Xo, Qxua^Xo, Qxua^Xo, Qxua^Xo, Qxua^Xo, Qxua^Xo, Qxua^Xo, Qxua^Xo, Qxua^Xo, Qxua^Xo, Qxua^Xo, Qxua^Xo, Qxua^Xo, Qxua, Gd, Qxua, Qxua, Qxua^Xo, Qxua^Xo, Qxua^Xo, Qxua^Xo, Qxua^Xo, Qxua^Xo, Qxua^Xo, Qxua^Xo, Qxua^Xo, Qxua^Xo, Qxua^Xo, Qxua^Xo, Qxua^Xo
Qxua^Xo, Qxua^Xo, Qxua^Xo, Qxua^Xo, Qxua^Xo, Qxua^Xo, Qxua^Xo, Qxua^Xo, Qxua^Xo, Qxua^Xo, Qxua^Xo, Qxua^Xo, Qxua^Xo, Qxua^Xo, Qxua^Xo, Qxua^Xo, Qxua^Xo, Qxua^Xo, Qxua^Xo, Qxua, Qxua^Xo, Qxua^Xo, Qxua^Xo, Qxua^Xo, Qxua^Xo, Qxua^Xo, Qxua^Xo, Qxua^Xo, Qxua^Xo, Qxua^Xo, Qxua^Xo, Qxua^Xo, Qxua^Xo, Qxua^Xo, Qxua^Xo
Qxua^Xo, Qxua^Xo, Qxua^Xo, Qxua^Xo, Qxua^Xo, Qxua^Xo, Qxua^Xo, Qxua^Xo, Qxua^Xo, Qxua^Xo, Qxua^Xo, Qxua^Xo, Qxua^Xo, Qxua^Xo, Qxua^Xo, Qxua^Xo, Qxua^Xo, Qxua^Xo, Qxua^Xo, Qxua^Xo, Qxua^Xo, Qxua^Xo, Qxua^Xo, Qxua^Xo, Qxua^Xo, Qxua^Xo, Qxua^Xo, Qxua^Xo, Qxua^Xo, Qxua^Xo, Qxua^Xo, Qxua^Xo, Qxua^Xo, Qxua^Xo, Qxua^Xo
Qxua^Xo, Qxua^Xo, Qxua^Xo, Qxua^Xo, Qxua^Xo, Qxua^Xo, Qxua^Xo, Qxua^Xo, Qxua^Xo, Qxua^Xo, Qxua^Xo, Qxua^Xo, Qxua^Xo, Qxua^Xo, Qxua^Xo, Qxua^Xo, Qxua^Xo, Qxua^Xo, Qxua^Xo, Qxua^Xo, Qxua^Xo, Qxua^Xo, Qxua^Xo, Qxua^Xo, Qxua^Xo, Qxua^Xo, Qxua^Xo, Qxua^Xo, Qxua^Xo, Qxua^Xo, Qxua^Xo, Qxua^Xo, Qxua^Xo, Qxua^Xo, Qxua^Xo
Qxua^Xo, Qxua^Xo, Qxua^Xo, Qxua^Xo, Qxua^Xo, Qxua^Xo, Qxua^Xo, Qxua^Xo, Qxua^Xo, Qxua^Xo, Qxua^Xo, Qxua^Xo, Qxua^Xo, Qxua^Xo, Qxua^Xo, Qxua^Xo, Qxua^Xo, Qxua^Xo, Qxua^Xo, Qxua^Xo, Qxua^Xo, Qxua^Xo, Qxua^Xo, Qxua^Xo, Qxua^Xo, Qxua^Xo, Qxua^Xo, Qxua^Xo, Qxua^Xo, Qxua^Xo, Qxua^Xo, Qxua^Xo, Qxua^Xo, Qxua^Xo, Qxua^Xo
Qxua^Xo, Qxua^Xo, Qxua^Xo, Qxua^Xo, Qxua^Xo, Qxua^Xo, Qxua^Xo, Qxua^Xo, Qxua^Xo, Qxua^Xo, Qxua^Xo, Qxua^Xo, Qxua^Xo, Qxua^Xo, Qxua^Xo, Qxua^Xo, Qxua^Xo, Qxua^Xo, Qxua^Xo, Qxua^Xo, Qxua^Xo, Qxua^Xo, Qxua^Xo, Qxua^Xo, Qxua^Xo, Qxua^Xo, Qxua^Xo, Qxua^Xo, Qxua^Xo, Qxua^Xo, Qxua^Xo, Qxua^Xo, Qxua^Xo, Qxua^Xo, Qxua^Xo
Qxua^Xo, Qxua^Xo, Qxua^Xo, Qxua^Xo, Qxua^Xo, Qxua^Xo, Qxua^Xo, Qxua^Xo, Qxua^Xo, Qxua^Xo, Qxua^Xo, Qxua^Xo, Qxua^Xo, Qxua^Xo, Qxua^Xo, Qxua^Xo, Qxua^Xo, Qxua^Xo, Qxua^Xo, Qxua^Xo, Qxua^Xo, Qxua^Xo, Qxua^Xo, Qxua^Xo, Qxua^Xo, Qxua^Xo, Qxua^Xo, Qxua^Xo, Qxua^Xo, Qxua^Xo, Qxua^Xo, Qxua^Xo, Qxua^Xo, Qxua^Xo, Qxua^Xo
Qxua^Xo, Qxua^Xo, Qxua^Xo, Qxua^Xo, Qxua^Xo, Qxua^Xo, Qxua^Xo, Qxua^Xo, Qxua^Xo, Qxua^Xo, Qxua^Xo, Qxua^Xo, Qxua^Xo, Qxua^Xo, Qxua^Xo, Qxua^Xo, Qxua^Xo, Qxua^Xo, Qxua^Xo, Qxua^Xo, Qxua^Xo, Qxua^Xo, Qxua^Xo, Qxua^Xo, Qxua^Xo, Qxua^Xo, Qxua^Xo, Qxua^Xo, Qxua^Xo, Qxua^Xo, Qxua^Xo, Qxua^Xo, Qxua^Xo, Qxua^Xo, Qxua^Xo
