Qxua^Xo, Qxua^Xo, Qxua^Xo, Qxua^Xo, Qxua^Xo, Qxua^Xo, Qxua^Xo, Qxua^Xo, Qxua^Xo, Qxua^Xo, Qxua^Xo, Qxua^Xo, Qxua^Xo, Qxua^Xo, Qxua^Xo, Qxua^Xo, Qxua^Xo, Qxua^Xo, Qxua^Xo, Qxua^Xo, Qxua^Xo, Qxua^Xo, Qxua^Xo, Qxua^Xo, Qxua^Xo, Qxua^Xo, Qxua^Xo, Qxua^Xo, Qxua^Xo, Qxua^Xo, Qxua^Xo, Qxua^Xo, Qxua^Xo, Qxua^Xo, Qxua^Xo, Qxua^Xo, Qxua^Xo, Qxua^Xo, Qxua^Xo, Qxua^Xo, Qxua^Xo, Qxua^Xo, Qxua^Xo, Qxua^Xo, Qxua^Xo, Qxua^Xo
Qxua^Xo, Qxua^Xo, Qxua^Xo, Qxua^Xo, Qxua^Xo, Qxua^Xo, Qxua^Xo, Qxua^Xo, Qxua^Xo, Qxua^Xo, Qxua^Xo, Qxua^Xo, Qxua^Xo, Qxua^Xo, Qxua^Xo, Qxua^Xo, Qxua^Xo, Qxua^Xo, Qxua^Xo, Qxua^Xo, Qxua^Xo, Qxua^Xo, Qxua^Xo, Qxua^Xo, Gd^Xo, Qxua^Xo, Gd^Xo, Qxua^Xo, Qxua^Xo, Qxua^Xo, Qxua^Xo, Qxua^Xo, Qxua^Xo, Qxua^Xo, Qxua^Xo, Qxua^Xo, Qxua^Xo, Qxua^Xo, Qxua^Xo, Qxua^Xo, Qxua^Xo, Qxua^Xo, Qxua^Xo, Qxua^Xo, Qxua^Xo, Qxua^Xo
Qxua^Xo, Qxua^Xo, Qxua^Xo, Qxua^Xo, Qxua^Xo, Qxua^Xo, Qxua^Xo, Qxua^Xo, Qxua^Xo, Qxua^Xo, Qxua^Xo, Qxua^Xo, Qxua^Xo, Qxua^Xo, Qxua^Xo, Qxua^Xo, Qxua^Xo, Qxua^Xo, Qxua^Xo, Qxua^Xo, Qxua^Xo, Qxua^Xo, Gd^Xo, Gd^Xo, Qxua^Xo, Gd^Xo, Gd^Xo, Qxua^Xo, Qxua^Xo, Qxua^Xo, Qxua^Xo, Qxua^Xo, Gd^Xo, Qxua^Xo, Gd^Xo, Qxua^Xo, Qxua^Xo, Qxua^Xo, Qxua^Xo, Qxua^Xo, Qxua^Xo, Qxua^Xo, Qxua^Xo, Qxua^Xo, Qxua^Xo, Qxua^Xo
Qxua^Xo, Qxua^Xo, Qxua^Xo, Qxua^Xo, Qxua^Xo, Qxua^Xo, Qxua^Xo, Qxua^Xo, Qxua^Xo, Qxua^Xo, Gd^Xo, Qxua^Xo, Gd^Xo, Gd^Xo, Qxua^Xo, Gd^Xo, Gd^Xo, Qxua^Xo, Qxua^Xo, Qxua^Xo, Qxua^Xo, Qxua^Xo, Qxua^Xo, Gd^Xo, Qxua^Xo, Qxua^Xo, Qxua^Xo, Qxua^Xo, Qxua^Xo, Gd^Xo, Qxua^Xo, Qxua^Xo, Qxua^Xo, Qxua^Xo, Gd^Xo, Qxua^Xo, Qxua^Xo, Qxua^Xo, Qxua^Xo, Qxua^Xo, Qxua^Xo, Qxua^Xo, Qxua^Xo, Qxua^Xo, Qxua^Xo, Qxua^Xo
Qxua^Xo, Qxua^Xo, Qxua^Xo, Qxua^Xo, Qxua^Xo, Qxua^Xo, Qxua^Xo, Qxua^Xo, Gd^Xo, Gd^Xo, Gd^Xo, Qxua^Xo, Qxua^Xo, Qxua^Xo, Qxua^Xo, Qxua^Xo, Qxua^Xo, Qxua^Xo, Qxua^Xo, Qxua^Xo, Qxua^Xo, Qxua^Xo, Qxua^Xo, Qxua^Xo, Qxua^Xo, Qxua^Xo, Qxua^Xo, Qxua^Xo, Qxua^Xo, Gd^Xo, Gd^Xo, Gd^Xo, Qxua^Xo, Qxua^Xo, Qxua^Xo, Qxua^Xo, Qxua^Xo, Qxua^Xo, Qxua^Xo, Qxua^Xo, Qxua^Xo, Qxua^Xo, Qxua^Xo, Qxua^Xo, Qxua^Xo, Qxua^Xo
Qxua^Xo, Qxua^Xo, Qxua^Xo, Qxua^Xo, Qxua^Xo, Qxua^Xo, Qxua^Xo, Qxua^Xo, Gd^Xo, Qxua^Xo, Gd^Xo, Gd^Xo, Qxua^Xo, Qxua^Xo, Qxua^Xo, Qxua^Xo, Qxua^Xo, Qxua^Xo, Qxua^Xo, Qxua^Xo, Gd, Qxua^Xo, Qxua^Xo, Qxua^Xo, Qxua^Xo, Gd, Gll, Qxua^Xo, Gd, Qxua^Xo, Qxua^Xo, Qxua^Xo, Qxua^Xo, Gd^Xo, Qxua^Xo, Qxua^Xo, Qxua^Xo, Qxua^Xo, Qxua^Xo, Qxua^Xo, Qxua^Xo, Qxua^Xo, Qxua^Xo, Qxua^Xo, Qxua^Xo, Qxua^Xo
Qxua^Xo, Qxua^Xo, Qxua^Xo, Qxua^Xo, Qxua^Xo, Qxua^Xo, Qxua^Xo, Qxua^Xo, Qxua^Xo, Qxua^Xo, Qxua^Xo, Qxua^Xo, Qxua^Xo, Qxua^Xo, Gd, Qxua^Xo, Gd^Xo, Qxua^Xo, Dd^Xo, Qxua^Xo, Gd, Qxua^Xo, Gd, Gd, Gll, Gll, Gll^Rusy, Gll, Gll, Qxua^Xo, Qxua^Xo, Qxua^Xo, Qxua^Xo, Qxua^Xo, Qxua^Xo, Qxua^Xo, Qxua^Xo, Qxua^Xo, Gd^Xo, Qxua^Xo, Qxua^Xo, Qxua^Xo, Qxua^Xo, Qxua^Xo, Qxua^Xo, Qxua^Xo
Qxua^Xo, Qxua^Xo, Qxua^Xo, Qxua^Xo, Gd^Xo, Qxua^Xo, Qxua^Xo, Qxua^Xo, Qxua^Xo, Qxua^Xo, Qxua^Xo, Qxua^Xo, Qxua^Xo, Qxua^Xo, Gd, Gd^Es, Gd^Xo, Dd^Xo, Dd^Xo, Gd, Gd, Gd, Gd, Gd, Qxua, Rd, Re, Re^Rusy, Re, Gll, Gll, Qxua^Xo, Gd, Qxua^Xo, Qxua^Xo, Qxua^Xo, Qxua^Xo, Gd^Xo, Gd^Xo, Gd^Xo, Qxua^Xo, Qxua^Xo, Qxua^Xo, Qxua^Xo, Qxua^Xo, Qxua^Xo
Qxua^Xo, Qxua^Xo, Qxua^Xo, Qxua^Xo, Gd^Xo, Qxua^Xo, Qxua^Xo, Gd^Xo, Qxua^Xo, Qxua^Xo, Gd^Xo, Qxua^Xo, Gd^Xo, Qxua^Xo, Qxua^Xo, Gd^Es, Gd^Xo, Dd^Ruty, Gll^Xo, Rd, Rd, Gd^Rusy, Rd, Qxua, Qxua, Qxua, Re, Re, Rd, Gll^Efm, Gll, Gd, Gd, Qxua^Xo, Qxua^Xo, Gd^Xo, Qxua^Xo, Qxua^Xo, Qxua^Xo, Gd^Xo, Qxua^Xo, Qxua^Xo, Qxua^Xo, Qxua^Xo, Qxua^Xo, Qxua^Xo
Qxua^Xo, Qxua^Xo, Gd^Xo, Qxua^Xo, Qxua^Xo, Qxua^Xo, Qxua^Xo, Qxua^Xo, Qxua^Xo, Qxua^Xo, Gd^Xo, Gd^Xo, Gd^Xo, Qxua^Xo, Qxua^Xo, Gd, Rd, Gd^Xo, Rd^Rusy, Gll^Rusy, Gd, Re, Re^Es, Re, Rd, Gd^Efm, Gd, Gd^Rusy, Rd, Re, Gll^Rusy, Gd, Qxua^Xo, Qxua^Xo, Qxua^Xo, Gd^Xo, Gd^Xo, Qxua^Xo, Qxua^Xo, Qxua^Xo, Qxua^Xo, Qxua^Xo, Qxua^Xo, Qxua^Xo, Qxua^Xo, Qxua^Xo
Qxua^Xo, Qxua^Xo, Qxua^Xo, Qxua^Xo, Gd^Xo, Qxua^Xo, Qxua^Xo, Qxua^Xo, Qxua^Xo, Qxua^Xo, Qxua^Xo, Gd^Xo, Qxua^Xo, Qxua^Xo, Gd, Gd, Rd^Rusy, Rd, Re, Gll, Re, Re, Rd, Re^Es, Rd^Es, Rd, Gd^Efm, Gd^Rusy, Gd^Rusy, Gd^Rusy, Gd^Efm, Gd, Qxua^Xo, Qxua^Xo, Qxua^Xo, Gd^Xo, Qxua^Xo, Qxua^Xo, Gd^Xo, Qxua^Xo, Qxua^Xo, Qxua^Xo, Qxua^Xo, Qxua^Xo, Qxua^Xo, Qxua^Xo
Qxua^Xo, Gd^Xo, Qxua^Xo, Qxua^Xo, Qxua^Xo, Qxua^Xo, Qxua^Xo, Qxua^Xo, Gd, Qxua^Xo, Gd, Qxua^Xo, Qxua^Xo, Qxua^Xo, Gll^Es, Gll, Rd^Rusy, Rd, Gd, Re, Re, 6 Rd, Rd, 4 Rd^Es, Rd, 2 Re, Re, Gd^Efm, Gd^Efm, Gd^Efm, Gd^Efm, Gd, Qxua^Xo, Qxua^Xo, Qxua^Xo, Qxua^Xo, Qxua^Xo, Qxua^Xo, Gd^Xo, Gd^Xo, Qxua^Xo, Qxua^Xo, Qxua^Xo, Qxua^Xo, Qxua^Xo, Qxua^Xo
Qxua^Xo, Qxua^Xo, Qxua^Xo, Qxua^Xo, Qxua^Xo, Qxua^Xo, Qxua^Xo, Qxua^Xo, Gd, Gd, Rd, Gd, Gll^Es, Gll, Gd^Es, Gll^Rusy, Gll, Rd^Es, Re, Rd, Re, Re, Gd, Rd, Gd, Re, Rd^Rusy, Re^Efm, Rd, Gd^Es, Gd, Qxua^Xo, Dd^Xo, Qxua^Xo, Qxua^Xo, Qxua^Xo, Gd, Qxua^Xo, Qxua^Xo, Qxua^Xo, Qxua^Xo, Qxua^Xo, Qxua^Xo, Qxua^Xo, Qxua^Xo, Qxua^Xo
Qxua^Xo, Qxua^Xo, Qxua^Xo, Qxua^Xo, Qxua^Xo, Qxua^Xo, Qxua^Xo, Gd, Gd, Rd^Es, Gd^Es, Gd^Es, Gll, Gll^Es, Rd, Gll^Rusy, Rd^Es, Rd^Es, Rd, Rd, Rd^Rusy, Rd^Es, Gd^Rusy, Rd, Gd^Es, Gd, Re, Re, Re, Gd, Gd^Es, Dd^Xo, Rd^Ruty, Dd^Xo, Gd^Es, Gd^Efm, Gd, Gd, Gd, Qxua^Xo, Qxua^Xo, Qxua^Xo, Qxua^Xo, Qxua^Xo, Qxua^Xo, Qxua^Xo
Qxua^Xo, Qxua^Xo, Qxua^Xo, Qxua^Xo, Qxua^Xo, Qxua^Xo, Qxua^Xo, Qxua^Xo, Gd, Gd, Gll^Rusy, Gll, Qxua, Qxua, Rd, Gd, Rd, Rd, Re, Gd^Es, Gd^Rusy, Gd^Es, Gd^Rusy, Gd^Es, Gd, Rd, Rd, Re, Re^Rusy, Rd^Rusy, Gd^Es, Gll^Xo, Gll^Xo, Dd^Xo, Gll, Gd^Es, Gd, Qxua^Xo, Qxua^Xo, Qxua^Xo, Qxua^Xo, Qxua^Xo, Qxua^Xo, Qxua^Xo, Qxua^Xo, Qxua^Xo
Qxua^Xo, Qxua^Xo, Qxua^Xo, Qxua^Xo, Qxua^Xo, Qxua^Xo, Qxua^Xo, Qxua^Xo, Gd, Gll, Gd^Rusy, Gll, Gd^Efm, Re, Re^Es, Rd^Es, Rd, Gd^Es, Re^Rusy, Gd^Rusy, Gll^Rusy, Gll^Rusy, Gll^Rusy, Gll^Rusy, Gd^Rusy, Rd^Rusy, Rd, Re, Re, Re, Rd, Rd, Rd, Gll^Rusy, Gd, Gd, Qxua^Xo, Qxua^Xo, Gd^Xo, Qxua^Xo, Qxua^Xo, Qxua^Xo, Qxua^Xo, Qxua^Xo, Qxua^Xo, Qxua^Xo
Qxua^Xo, Qxua^Xo, Gd^Xo, Gd^Xo, Qxua^Xo, Qxua^Xo, Qxua^Xo, Gd, Gd, Gd^Es, Rd, Gd^Es, Gd, Gd^Efm, Rd, Rd, Gd, Re, Re^Rusy, Gd^Rusy, Gd^Es, Gd^Rusy, Gll^Rusy, Gll^Rusy, Gd^Rusy, Gd^Es, Rd^Rusy, Rd, Rd^Es, Re, Re, Gll, Qxua, Gd, Gll, Qxua^Xo, Qxua^Xo, Qxua^Xo, Gd^Xo, Gd^Xo, Gd^Xo, Qxua^Xo, Qxua^Xo, Qxua^Xo, Qxua^Xo, Qxua^Xo
Qxua^Xo, Qxua^Xo, Qxua^Xo, Qxua^Xo, Qxua^Xo, Qxua^Xo, Gd, Gd, Gd, Rd, Re^Xo, Dd^Xo, Dd^Xo, Gd, Gd^Rusy, Qxua, Gd, Re, Re, Re^Es, Gd, Gll^Rusy, Gd^Rusy, Gll^Rusy, Gd^Rusy, Gd^Rusy, Gd, Gd, Rd^Es, Rd^Es, Rd^Es, Gll, Qxua, Qxua, Gll, Gd, Qxua^Xo, Qxua^Xo, Qxua^Xo, Gd^Xo, Qxua^Xo, Qxua^Xo, Qxua^Xo, Qxua^Xo, Qxua^Xo, Qxua^Xo
Qxua^Xo, Gd^Xo, Qxua^Xo, Qxua^Xo, Qxua^Xo, Qxua^Xo, Qxua^Xo, Qxua^Xo, Gd, Gd, Rd^Xo, Dd^Xo, Dd^Xo, Gd^Rusy, Rd, Gd, Qxua, Gd, Rd, Gd, Gd^Rusy, Gd^Rusy, Gd^Rusy, Rd, Rd, Rd, Gd, Rd, Re, Re, Gll^Rusy, Gll^Es, Gd, Gd, Rd^Rusy, Gd, Gd, Qxua^Xo, Qxua^Xo, Qxua^Xo, Qxua^Xo, Qxua^Xo, Qxua^Xo, Qxua^Xo, Qxua^Xo, Qxua^Xo
Qxua^Xo, Qxua^Xo, Qxua^Xo, Gd^Xo, Gd^Xo, Qxua^Xo, Qxua^Xo, Qxua^Xo, Qxua^Xo, Gd, Dd^Xo, Dd^Ruty, Dd^Xo, Gd, Rd, Rd, Qxua, Rd, Qxua, Gd, Re, Gd, Gd, Gd^Rusy, Gd, Rd, Re, Re, Re^Rusy, Re^Rusy, Gll^Es, Gd^Es, Rd^Es, Rd, Rd^Es, Gll^Es, Gd, Gd, Qxua^Xo, Qxua^Xo, Qxua^Xo, Qxua^Xo, Qxua^Xo, Qxua^Xo, Qxua^Xo, Qxua^Xo
Qxua^Xo, Qxua^Xo, Qxua^Xo, Qxua^Xo, Qxua^Xo, Qxua^Xo, Gll, Qxua^Xo, Gll^Efm, Gll, Gd^Efm, Dd^Xo, Gd, Re, Rd, Qxua, Qxua, Qxua, Gd, Re, Gd, Re, Rd, Rd, Rd, Re, Gd, Gd, Gd^Rusy, Re^Rusy, Gd^Rusy, Gd^Es, Rd^Es, Rd, Gd, Gd, Gd, Qxua^Xo, Qxua^Xo, Qxua^Xo, Qxua^Xo, Qxua^Xo, Qxua^Xo, Qxua^Xo, Qxua^Xo, Qxua^Xo
Qxua^Xo, Qxua^Xo, Qxua^Xo, Qxua^Xo, Qxua^Xo, Qxua^Xo, Gd, Gll, Gll^Efm, Rd^Es, Re, Re, Gd^Efm, Rd, Gll^Es, Rd^Es, Gll, Qxua, Gd^Rusy, Gd^Rusy, Re, Re, Rd^Es, Rd^Es, Rd, Re, Re, Gd, Rd, Gd^Rusy, Gd, Gd, Gd, Gd, Gd, Qxua^Xo, Qxua^Xo, Qxua^Xo, Gd^Xo, Qxua^Xo, Gd^Xo, Gd^Xo, Qxua^Xo, Qxua^Xo, Qxua^Xo, Qxua^Xo
Qxua^Xo, Qxua^Xo, Qxua^Xo, Qxua^Xo, Qxua^Xo, Gd, Gd, Gll^Efm, Gll, Rd, Rd^Es, Re, Re, Gd^Rusy, Gll^Rusy, Gd^Rusy, Gll^Rusy, Gll^Rusy, Gd^Rusy, Re, Re^Rusy, Re, Rd, Rd^Es, Rd, Re, Rd, Gd^Es, Gd^Es, Rd, Gd, Gd, Qxua^Xo, Gd, Qxua^Xo, Gd, Qxua^Xo, Qxua^Xo, Gd^Xo, Gd^Xo, Qxua^Xo, Qxua^Xo, Qxua^Xo, Qxua^Xo, Qxua^Xo, Qxua^Xo
Qxua^Xo, Qxua^Xo, Qxua^Xo, Qxua^Xo, Qxua^Xo, Gd, Qxua^Xo, Gd, Qxua^Xo, Gd, Gd, Gd^Es, Re, Re, Gll, Gll^Rusy, Gd^Rusy, Gd^Rusy, Gd^Rusy, Gd^Rusy, Re^Rusy, Rd^Rusy, Re, Qxua, Qxua, Rd, Rd, Rd, Gd^Es, Rd, Rd, Gd, Qxua^Xo, Qxua^Xo, Qxua^Xo, Qxua^Xo, Qxua^Xo, Qxua^Xo, Qxua^Xo, Qxua^Xo, Qxua^Xo, Qxua^Xo, Qxua^Xo, Qxua^Xo, Qxua^Xo, Qxua^Xo
Qxua^Xo, Qxua^Xo, Qxua^Xo, Qxua^Xo, Qxua^Xo, Qxua^Xo, Qxua^Xo, Qxua^Xo, Qxua^Xo, Qxua^Xo, Qxua^Xo, Gd, Gd, Gll, Gll^Es, Gll^Rusy, Gd, Gd^Rusy, Gd^Es, Rd^Es, Rd, Re^Rusy, Rd, Rd, Gd^Efm, Rd^Es, Gd^Efm, Gd^Efm, Gd^Es, Gd^Efm, Gd^Efm, Gd, Gd, Qxua^Xo, Qxua^Xo, Qxua^Xo, Qxua^Xo, Qxua^Xo, Qxua^Xo, Qxua^Xo, Qxua^Xo, Qxua^Xo, Qxua^Xo, Qxua^Xo, Qxua^Xo, Qxua^Xo
Qxua^Xo, Qxua^Xo, Qxua^Xo, Qxua^Xo, Qxua^Xo, Qxua^Xo, Qxua^Xo, Gd^Xo, Gd^Xo, Qxua^Xo, Qxua^Xo, Gd, Gd, Gll, Gd, Gll, Qxua^Xo, Gd, Gd^Es, Gd, Rd, 1 Gd, Gd^Es, 3 Gd, Gd^Efm, 5 Gd^Efm, Gd^Efm, Gd, Qxua^Xo, Gd, Gd, Gd, Qxua^Xo, Qxua^Xo, Qxua^Xo, Qxua^Xo, Qxua^Xo, Qxua^Xo, Qxua^Xo, Qxua^Xo, Qxua^Xo, Qxua^Xo, Qxua^Xo, Qxua^Xo, Qxua^Xo, Qxua^Xo
Qxua^Xo, Qxua^Xo, Qxua^Xo, Qxua^Xo, Gd^Xo, Gd^Xo, Qxua^Xo, Gd^Xo, Gd^Xo, Qxua^Xo, Qxua^Xo, Qxua^Xo, Gd, Gd, Gd, Gd, Qxua^Xo, Gd, Gd, Rd, Rd^Es, Gd, Gd, Gd^Es, Gd, Gd, Qxua^Xo, Gd, Qxua^Xo, Qxua^Xo, Gd, Gd, Qxua^Xo, Qxua^Xo, Qxua^Xo, Qxua^Xo, Qxua^Xo, Qxua^Xo, Qxua^Xo, Qxua^Xo, Qxua^Xo, Qxua^Xo, Qxua^Xo, Qxua^Xo, Qxua^Xo, Qxua^Xo
Qxua^Xo, Qxua^Xo, Qxua^Xo, Qxua^Xo, Qxua^Xo, Gd^Xo, Qxua^Xo, Gd^Xo, Gd^Xo, Qxua^Xo, Qxua^Xo, Qxua^Xo, Qxua^Xo, Qxua^Xo, Qxua^Xo, Qxua^Xo, Qxua^Xo, Qxua^Xo, Qxua^Xo, Gd, Gd, Gd, Qxua^Xo, Qxua^Xo, Qxua^Xo, Qxua^Xo, Qxua^Xo, Qxua^Xo, Qxua^Xo, Qxua^Xo, Qxua^Xo, Qxua^Xo, Qxua^Xo, Qxua^Xo, Qxua^Xo, Qxua^Xo, Qxua^Xo, Qxua^Xo, Qxua^Xo, Qxua^Xo, Qxua^Xo, Qxua^Xo, Qxua^Xo, Qxua^Xo, Qxua^Xo, Qxua^Xo
Qxua^Xo, Qxua^Xo, Qxua^Xo, Qxua^Xo, Qxua^Xo, Qxua^Xo, Gd^Xo, Gd^Xo, Qxua^Xo, Gd^Xo, Gd^Xo, Qxua^Xo, Qxua^Xo, Qxua^Xo, Qxua^Xo, Qxua^Xo, Qxua^Xo, Qxua^Xo, Qxua^Xo, Gd, Gd, Qxua^Xo, Qxua^Xo, Qxua^Xo, Gd^Xo, Gd^Xo, Qxua^Xo, Qxua^Xo, Qxua^Xo, Qxua^Xo, Qxua^Xo, Qxua^Xo, Qxua^Xo, Qxua^Xo, Qxua^Xo, Qxua^Xo, Qxua^Xo, Qxua^Xo, Qxua^Xo, Qxua^Xo, Qxua^Xo, Qxua^Xo, Qxua^Xo, Qxua^Xo, Qxua^Xo, Qxua^Xo
Qxua^Xo, Qxua^Xo, Qxua^Xo, Qxua^Xo, Qxua^Xo, Qxua^Xo, Gd^Xo, Qxua^Xo, Gd^Xo, Qxua^Xo, Qxua^Xo, Qxua^Xo, Qxua^Xo, Qxua^Xo, Qxua^Xo, Qxua^Xo, Qxua^Xo, Qxua^Xo, Qxua^Xo, Qxua^Xo, Qxua^Xo, Qxua^Xo, Gd^Xo, Gd^Xo, Gd^Xo, Qxua^Xo, Qxua^Xo, Gd^Xo, Qxua^Xo, Qxua^Xo, Qxua^Xo, Gd^Xo, Qxua^Xo, Qxua^Xo, Qxua^Xo, Qxua^Xo, Qxua^Xo, Qxua^Xo, Qxua^Xo, Qxua^Xo, Qxua^Xo, Qxua^Xo, Qxua^Xo, Qxua^Xo, Qxua^Xo, Qxua^Xo
Qxua^Xo, Qxua^Xo, Qxua^Xo, Qxua^Xo, Qxua^Xo, Qxua^Xo, Qxua^Xo, Qxua^Xo, Qxua^Xo, Qxua^Xo, Qxua^Xo, Qxua^Xo, Gd^Xo, Gd^Xo, Qxua^Xo, Gd^Xo, Qxua^Xo, Qxua^Xo, Qxua^Xo, Qxua^Xo, Qxua^Xo, Qxua^Xo, Qxua^Xo, Gd^Xo, Qxua^Xo, Qxua^Xo, Gd^Xo, Qxua^Xo, Qxua^Xo, Gd^Xo, Qxua^Xo, Qxua^Xo, Qxua^Xo, Qxua^Xo, Qxua^Xo, Qxua^Xo, Qxua^Xo, Qxua^Xo, Qxua^Xo, Qxua^Xo, Qxua^Xo, Qxua^Xo, Qxua^Xo, Qxua^Xo, Qxua^Xo, Qxua^Xo
Qxua^Xo, Qxua^Xo, Qxua^Xo, Qxua^Xo, Qxua^Xo, Qxua^Xo, Qxua^Xo, Qxua^Xo, Qxua^Xo, Qxua^Xo, Qxua^Xo, Qxua^Xo, Qxua^Xo, Qxua^Xo, Qxua^Xo, Gd^Xo, Qxua^Xo, Qxua^Xo, Qxua^Xo, Qxua^Xo, Qxua^Xo, Qxua^Xo, Qxua^Xo, Qxua^Xo, Gd^Xo, Gd^Xo, Qxua^Xo, Qxua^Xo, Qxua^Xo, Qxua^Xo, Qxua^Xo, Qxua^Xo, Qxua^Xo, Qxua^Xo, Qxua^Xo, Qxua^Xo, Qxua^Xo, Qxua^Xo, Qxua^Xo, Qxua^Xo, Qxua^Xo, Qxua^Xo, Qxua^Xo, Qxua^Xo, Qxua^Xo, Qxua^Xo
Qxua^Xo, Qxua^Xo, Qxua^Xo, Qxua^Xo, Qxua^Xo, Qxua^Xo, Qxua^Xo, Qxua^Xo, Qxua^Xo, Qxua^Xo, Qxua^Xo, Qxua^Xo, Qxua^Xo, Qxua^Xo, Qxua^Xo, Qxua^Xo, Qxua^Xo, Qxua^Xo, Qxua^Xo, Qxua^Xo, Qxua^Xo, Qxua^Xo, Qxua^Xo, Qxua^Xo, Qxua^Xo, Qxua^Xo, Qxua^Xo, Qxua^Xo, Qxua^Xo, Qxua^Xo, Qxua^Xo, Qxua^Xo, Qxua^Xo, Qxua^Xo, Qxua^Xo, Qxua^Xo, Qxua^Xo, Qxua^Xo, Qxua^Xo, Qxua^Xo, Qxua^Xo, Qxua^Xo, Qxua^Xo, Qxua^Xo, Qxua^Xo, Qxua^Xo
Qxua^Xo, Qxua^Xo, Qxua^Xo, Qxua^Xo, Qxua^Xo, Qxua^Xo, Qxua^Xo, Qxua^Xo, Qxua^Xo, Qxua^Xo, Qxua^Xo, Qxua^Xo, Qxua^Xo, Qxua^Xo, Qxua^Xo, Qxua^Xo, Qxua^Xo, Qxua^Xo, Qxua^Xo, Qxua^Xo, Qxua^Xo, Qxua^Xo, Qxua^Xo, Qxua^Xo, Qxua^Xo, Qxua^Xo, Qxua^Xo, Qxua^Xo, Qxua^Xo, Qxua^Xo, Qxua^Xo, Qxua^Xo, Qxua^Xo, Qxua^Xo, Qxua^Xo, Qxua^Xo, Qxua^Xo, Qxua^Xo, Qxua^Xo, Qxua^Xo, Qxua^Xo, Qxua^Xo, Qxua^Xo, Qxua^Xo, Qxua^Xo, Qxua^Xo
Qxua^Xo, Qxua^Xo, Qxua^Xo, Qxua^Xo, Qxua^Xo, Qxua^Xo, Qxua^Xo, Qxua^Xo, Qxua^Xo, Qxua^Xo, Qxua^Xo, Qxua^Xo, Qxua^Xo, Qxua^Xo, Qxua^Xo, Qxua^Xo, Qxua^Xo, Qxua^Xo, Qxua^Xo, Qxua^Xo, Qxua^Xo, Qxua^Xo, Qxua^Xo, Qxua^Xo, Qxua^Xo, Qxua^Xo, Qxua^Xo, Qxua^Xo, Qxua^Xo, Qxua^Xo, Qxua^Xo, Qxua^Xo, Qxua^Xo, Qxua^Xo, Qxua^Xo, Qxua^Xo, Qxua^Xo, Qxua^Xo, Qxua^Xo, Qxua^Xo, Qxua^Xo, Qxua^Xo, Qxua^Xo, Qxua^Xo, Qxua^Xo, Qxua^Xo
